1111111111111111111111111111111111111111111111111111111111111111
                                        11111111111111||11111111
            11111111    111111111111                        1111
  PP    1111111111111111111111111111                  BB    1111
111111111111111111111111111111111111    111111111111______111111
1111111111111111111111111111111111111111111111111111      111111
1111111111111111111111111111111111111111111111111111      111111
1111111111111111111111111111111111111111111111111111      111111
1111111111111111111111111111111111111111111111111111      111111
1111111111111111111111111111111111111111111111111111      111111
1111111111111111111111111111111111111111111111111111      111111
1111111111111111111111111111111111111111111111111111      111111
1111111111111111111111111111111111111111111111111111      111111
1111111111111111111111111111111111111111111111111111      111111
111111111111111111111111111111111111111111111111              11
111111111111111111111111111111111111111111111111              11
111111111111111111111111111111111111111111111111              11
111111111111111111111111111111111111111111111111              11
1111111111111111111111111111111111111111111111111111------111111
11111111||1111111111||111111111111111111111111111111      111111
111111                  1111111111111111111111111111      111111
111111  BB              1111111111111111111111111111      111111
111111______111111______1111111111111111111111111111------111111
111111      111111      1111111111111111111111111111      111111
111111      111111      1111111111111111111111111111      111111
111111      111111      1111111111111111111111111111      111111
111111      111111      11111111            11111111------111111
111111      111111                                        111111
111111      111111  BB      111111111111                  111111
111111      1111111111111111111111111111111111111111111111111111
111111      1111111111111111111111111111111111111111111111111111
111111WWWWWW1111111111111111111111111111111111111111111111111111